R 1920 1080
S ./text/barrel.xpm
NO ./text/clari.xpm
WE ./text/nat.xpm
SO ./text/tucos.xpm
EA ./text/dani.xpm

F  179,204,204
C  128,191,255


111111111111111
1000000S0000001
100000000000001
100000020000001
100000000000001
100000020000001
100000000000001
100000020000001
100000000000001
100000020000001
100000000000001
100000020000001
100000000000001
100000020000001
100000000000001
100000020000001
100000000000001
100000020000001
100000000000001
100000020000001
100000000000001
100000020000001
1000000000000001
10000000000000001
11111111111111111
